acele	acele	urgent ly 
ʻaḍale	adele	muscle
ʻafuitmek	affetmek	to forgive
aile	aile	family
ʻaqd mukâvele	akit  mukavele	contract
ʻaql	akıl	wisdom
ʻalaqe	alaka lı 	relevant  related to
ʻâmil	amil	factor
ʻamaliyyah	ameliye	operation  process
amme	amme	public  community
a nane	anane	tradition
asakir	asker	soldier
asr		asır	century
bâriz	bariz	obvious  accurate
basîṭ	basit	easy  simple
bazı	bazı	some  pronoun 
abyâz	beyaz	white
camiʻah	camîa	community
cebren	cebren	forcefully
calsah	celse	 law  hearing  session
ceninisakıt	ceninisakıt	miscarriage
cenûb	cenup	south
cerahah	cerahat	pus
cevâb	cevap	answer.
cihaz	cihaz	apparatus
civarı	civarı	approximately  around
cümle	cümle	sentence.
defʻa kere	defa  kere	times  repetition 
dâ‘ir	dair	pertinent  to 
define	define	treasure
delil	delil	evidence
devr	devir	era
devre	devre	semester
ebʻâd	ebat	dimension  size.
ebedî	ebedî	forever
ecdâd	ecdat	ancestry
ecel	ecel	 predestined time of  death
acnebi	ecnebi	stranger  foreigner
edebiyyat	edebiyat	literature
ehemmiyyet	ehemmiyet	importance
elbise	elbise	cloth
emr	emir	order  command
amniyyah	emniyet	security
eser	eser	production  music  film 
esîr	esir	hostage
etraf	etraf	surroundings  surrounding area
evrâk	evrak	paper document
evvel	evvel	before
faʻâl	faal	active
faiz	faiz	interest  monetary 
fakir fukara	fakir	poor
fâydah	fayda	benefit  utility
fenn ʻilm	fen  ilim	science
feyezan	feyezan	flood  overflow
furqah	fırkat	disparity
fikr	fikir	opinion
fiʻl	fiil	verb
garb	garp	west
gayr	gayri	non   other
gıda	gıda	food
hadise	hadise	event  happening  fact  occurrence
hâfıza	hafıza	memory
hafif	hafif	light  in weight 
hafriyyât	hafriyat	excavation
haqq	hak	portion
haqîqat	hakikat	reality
hâkim	hâkim	judge
hâl vazʻiyet	hâl  vaziyet	situation
halîta	halita	alloy
haʻmile	hamile	pregnant
harâb	harap	ruin
harâret	hararet	  heat    temperature
harekkat	hareket	movement  motion
harf	harf	letter
hasra	hasret	longing
hassas	hassas	sensitive
haşara	haşere	insect
hatâ kusûr	hata  kusur	mistake
hâtıra	hatıra	memoir
hayât ömr	hayat  ömür	life
haysiyyet	haysiyet	respectability
hazm	hazım	digestion
hediyye	hediye	gift
hey et	heyet	board  company 
hiddet	hiddet	anger
hikâye	hikâye	story
hilâf	hilaf	opposite
his	his	feeling
hôca	hoca	teacher
hukuk	hukuk	 judiciary  law
husûs	husus	subject
huzûr	huzur	comfort
hucre	hücre	cell
hücûm	hücum	attack
hürmet	hürmet	respect
ısrar	ısrar	insisting
ibtidâ‘î	iptidai	primary  primitive
ictima	içtima	meeting  gathering
içtima	içtima	new moon  astronomy 
ictimai	içtimai	communal
idrar	idrar	urine
iftihâr	iftihar	pride
ihtiras	ihtiras	passion
ihtiva	ihtiva etmek	to comprise
ihtiyâc	ihtiyaç	need
ihtiyâr	ihtiyar	old  age 
ihtiyât	ihtiyat	backup  spare
iktibas	iktibas	copying  in literature  referencing 
ilave	ilave	addition
ilhâm	ilham	inspiration
ʻimâr	imar	construction  development
imkân	imkân	opportunity  possibility
imlâ	imla	orthography
imtihân	imtihan	examination
imtiyâz	imtiyaz	franchise
inhisâr	inhisar	monopoly
insân	insan	human
intiba	intiba	impression
intihal	intihal	plagirism
irtifâʻ	irtifa	altitude
irsî	ırsi	hereditary
ism	isim	name
istiḥṣāl	istihsal	production
istiqlal	istiklal	independence  freedom
istirâhat	istirahat	rest
istisḳāl	istiskal	abasement
istisnâ 	istisna	exception
iştigâl	iştigal	occupation
iştirâk	iştirak	association
izâh	izah	clarification
izdivâc	izdivaç	marriage
kâbiliyet	kabiliyet	talent  ability
kader	kader	fate
qaffa	kafa	head
kâfi	kâfi	enough
kâ inât	kâinat	universe
kalb	kalp	heart
kânûn	kanun	law
kanunuesasi	kanunuesasi	constitution  law 
kâfiye	kafiye	rhyme
kânûn ıevvel	kânûn ı evvel	December
kânûn ısânî	kânûn ı sânî	January
kelime	kelime	word
ghermez	kırmızı	red
kısm	kısım	part
ketab	kitap	book
kufr	küfür	curse
kuvvet	kuvvet	power  force
küre	küre	sphere
lâtîfe	latife	joke
lisân	lisan	language
lûġat	lügat	dictionary
lüzûmlu	lüzumlu	necessary
maʻâş	maaş	salary
maʻbed	mabet	temple
maddî	maddî	material  materialistic
mafsal	mafsal	ligament
mağdûr	mağdur	wronged  injured
maʻlubiyyat	mağlubiyet	defeat
mahfuz	mahfuz	hidden
mahlûk	mahluk	creature
mahsûl	mahsul	product
mahsûs	mahsus	peculiar
maksad	maksat	goal
gaye	gaye	
hedef	hedef	
maʻkûl	makul	reasonable
maʻnah	mâna	meaning
manevî	manevî	moral  spiritual
mâniʻ	mani	obstacle
masraf	masraf	cost
mavi	mavi	blue
mecaz istiare	mecaz	metaphor
mecbûr	mecbur	obligation  obligatory
mechûl	meçhul	unknown
madanni	medeni	civil
madanniyyat	medeniyet	civilization
mefhûm	mefhum	concept
mekrûh	mekruh	disgusting
meleke	meleke	habit
melez	melez	hybrid
memleket	memleket	country
merâsim	merasim	ceremony
mersiye	mersiye	elegy
mesafe	mesafe	distance
mesame	mesame	pore
mesane	mesane	urinary bladder
meselâ	mesela	for example
mesele	mesele	problem
mesʻûd	mesut	happy
maʻsûliyyat	mesuliyet	responsibility
meşhûr	meşhur	famous
meşrûbât	meşrubat	beverage
mevkiʻmekân	mevki  mekân	location
meydân sâha	meydan  saha	open area  plaza
meyl	meyil	inclination
mezar	mezar	cemetery
mıntıka	mıntıka	region
mısra	mısra	verse
mirâs	miras	inheritance
misâfir	misafir	guest
misâl	misal	example
miskîn	miskin	lazy
muʻâmele	muamele	treatment  behavior
muʻammâ	muamma	puzzle  trivia
muʻâsır	muasır	contemporary
muʻâvin	muavin	helper
muʻcize	mucize	miracle
mugaddii	mugaddi	nourisher
mugalata	mugalata	deceptive statement
muganni muganniye	muganni muganniye	singer
mugayeret	mugayeret	irregularity
mugayir	mugayir	irregular
mugber	muğber	the state of one not talking to another
muglak	muğlak	ambiguous
muhabere	muhabere	communication
muhaceret	muhaceret	emigration
muhacim	muhacim	attacker  offender
muhacir	muhacir	immigrant
muhaddep	muhaddep	convex
muhafaza	muhafaza	conservation
muhafazakar	muhafazakar	conservative
muhafız	muhafız	protector
muhakeme	muhakeme	judgment  argumentation
muddat	müddet	duration
muhakkak	muhakkak	certain ly 
muhakkik	muhakkik	investigator
muhal	muhal	impossible
muhallaffat	muhalefet	opposition
muhammen	muhammen	pre determined
muhammes	muhammes	pentagon
muhammin	muhammin	one that pre determines
muhârebe harb	muharebe  harp	war
muharip	muharip	warrior
muharrer	muharrer	written
muharrik	muharrik	provoker
muharriş	muharriş	aggravator
muhassamat	muhasamat	collusion
muhasara	muhasara	siege
muhasebe	muhasebe	accounting  bookkeeping
muhasebeci	muhasebeci	accountant  bookkeeper
muhassır	muhasır	one that envelops
muhassala	muhassala	resultant
muhassas	muhassas	reserved
muhat	muhat	one that s enveloped  sieged
muhavvil	muhavvil	converter
muhavvile	muhavvile	transformer
muhtemel	muhtemel	possible
muhteviyyât	muhteviyat	ingredients
mukaddes	mukaddes	sacred
muntazam	muntazam	tidy
murabbaʻ	murabba	square
murafaa	murafaa	court hearing
muʻtedil	mutedil	moderate ly 
muvaffakıyyet	muvaffakiyet	success
mübalâga	mübalağa	exaggeration
mücâdele	mücadele	endeavor
mücerrit	mücerrit	abstract
müdâfaʻa	müdafaa	sustain  protect  defend
müdâhale	müdahale	intervention
müddet	müddet	duration
mudrike	müdrike	intellect  in psychology 
mudrir	müdrir	diuretic
muebbet	müebbet	lifelong  forever
mueccel	müeccel	delayed
mueddep	müeddep	well behaved  demure
muelleffat	müellefat	 written  piece
muellif muharrir	müellif  muharrir	writer
muemmen	müemmen	secured
muennes	müennes	feminine
mu‘essese	müessese	foundation
muessif	müessif	saddenning
muessir	müessir	touching
muessis	müessis	founder
mueyyide	müeyyide	sanction
mufekkrireh	müfekkire	thought capacity
muferrih	müferrih	relaxing  refreshing
mufrett	müfret	singular
muflis	müflis	one that s gone bankrupt
mühim	mühim	important
mü‘min	mümin	believer
münâsebet	münasebet	relation
mürâcaʻat	müracaat	application
mürekkeb	mürekkep	composed of
murrettip	mürettip	type setter
müsâbaka	müsabaka	match  competition
müsâmaha	müsamaha	tolerance
musavi	müsavi	equal
müstehcen	müstehcen	inappropriate  obscene
mustamlak	müstemleke	colony  exploitee 
müsvedde	müsvedde	draft
muşabbih mumassil	müşabih  mümasil	similar
muşşabbahat	müşabehet	similarity
müşahhas	müşahhas	concrete  in concept  the opposite of abstract 
müşkül	müşkül	difficult
muşkul pesend	müşkülpesent	fussy
muşrik	müşrik	polytheist
müştak	müştak	derivative
muştehi	müştehi	willing  person 
muşteki	müşteki	one who complains  whiner
muştemilat	müştemilat	attachment  appandage
muşterek	müşterek	partner
muştereken	müştereken	jointly
muşteri	müşteri	customer
mut‘a	müt a	temporary earning
mütâlâʻa	mütalâa	thought
mütâreke	mütareke	armistice
muteaddit	müteaddit	a lot  many
muteaffin	müteaffin	malodorous
muteahhid	müteahhit	contractor
muteahhidlik	müteahhitlik	contractor  as a profession 
muteakiben	müteakiben	following
muteakib	müteakip	after  thereafter
mutealiye	mütealiye	transcendentalism
muteallik	müteallik	related  to 
muteammim	müteammim	something that has widespread
mutearife	mütearife	axiom
mutebaki	mütebaki	remaining
mutebasbıs	mütebasbıs	slimy
mutebeddil	mütebeddil	one that changes  undecided
mutebessim	mütebessim	one that smiles
mutecanis	mütecanis	homogenous
mutecasir	mütecasir	one who dares
mutecaviz	mütecaviz	attacker
mutedeyyin	mütedeyyin	religious
muteessir	müteessir	sad  person 
mutefekkir	mütefekkir	thinker  intellectual
müteferrik	müteferrik	untidy
mutehammil	mütehammil	durable
muteharrik	müteharrik	mobile
mütehassıs	mütehassıs	expert
muteşşebbis	müteşebbis	entrepreneur
mütevâzî	mütevazi	humble
muteveffa	müteveffa	dead
muttefik	müttefik	ally
muzayyadeh	müzayede	auction
müzmin	müzmin	chronic
nadir ender	nadir  ender	rare ly 
nağme	nağme	melody
nafile	nafile	futile
nasîhat	nasihat	advice  counsel
nâzır	nazır	minister
nefes	nefes	breath
nesiç	nesiç	tissue
nesl	nesil	generation
netîce	netice	result
nezif	nezif	hemorrhage
nısf	nısıf	half
nihâyet	nihayet	final ly 
nikâh	nikâh	wedding
nisbet	nispet	ratio
nutk	nutuk	speech
ragmen	rağmen	despite  in spite of
rafāh	refah	prosperity
re y	rey	vote
re îs	reis	president
ruh	ruh	spirit
rutûbet	rutubet	moisture
rü ya	rüya	dream
ّsade sa aid	sade	plain
safha	safha	stage  phase
safra	safra	bile
sahil	sahil	coast
sahip	sahip	owner
sahte	sahte	fake
samimî	samimi	sincere
sath	satıh	surface
sayyâre	seyyare	car
sebeb	sebep	reason
safarat	sefaret	embassy
selâmet	selamet	health  soundness
semâ	sema	sky
sene	sene	year
seviye	seviye	level
sıhhat	sıhhat	health
sihr	sihir	magic
sohbet	sohbet	chat
su âl	sual	question
sulh	sulh	peace
sunî	suni	artificial
sükût	sükût	silence
sürʻat	sürat	velocity  speed
şâhid	şahit	witness
şair	şair	poet
şark	şark	east
şart	şart	condition
şatafat lı 	şatafat lı 	spectacular  noun and adjective 
şimâl	şimal	north
şuʻûr	şuur	consciousness
şübheli	şüpheli	suspect  someone charged with an offense
taalluk	taalluk	connection  relation
tabaqqa	tabaka	layer
ṭabîʻat	tabiat	nature
ṭabîʻî	tabii	natural
taʻbîr ifâde	tabir  ifade	narration
ṭâbiyet	tâbiyet	nationality
tahlil	tahlil	 laboratory  test  as in medicine 
tahmin	tahmin	guess  prediction
taʻkib	takip	follow up
ṭaleb	talep	request  demand  wish
ṭalebe	talebe	student  plural of ṭâlib   seeker  [of knowledge] 
taʻmîr	tamir	repair  renovation
taʻdîlât	taʻdîlât	
taraf	taraf	side
taraftar	taraftar	supporter  proponent
tarih	tarih	date  in time 
tasallut	tasallut	 sexual  harassment
tasavvur	tasavvur	imagine
tasdîk	tasdik	approve
tashîh	tashih	correction
tasvîr	tasvir	description
tayyâre	tayyare	airplane
tavsiye	tavsiye	advice
teʻâdül	teadül	equivalence
teʻâmül	teamül	reaction  behavior
tebessüm	tebessüm	smile
tebdîl	tebdil	change
tebrîk	tebrik	congratulate
tecellî	tecelli	emerge  appear
tecessüm	tecessüm	appearance  manifestation
tecrübe	tecrübe	experience
techîzât	teçhizat	equipment
tedavi	tedavi	therapy
tedbîr	tedbir	precaution
te essür	teessür	agony
teferruat	teferruat	detail
tekâmül	tekamül	maturation  metamorphosis  evolution
tekaʻüd	tekaüt	retirement
tekeffül	tekeffül	standing surety
teklîf	teklif	proposal
tekrar	tekrar	again
telâş	telaş	worry
tenâsüb	tenasüp	congruity
tenbîh	tembih	warning
tercüme	tercüme	translation
terreddut	tereddüt	hesitancy
tertip	tertip	order  tidiness
tesir	tesir	effect
teselli	teselli	console
teşhis	teşhis	diagnosis
teshkil	teşkil etmek	to constitute
teşvik	teşvik	 providing  incentive  provocation
usûl	usul	method
unsur	unsur	constituent  element
unvan	ünvan	 professional  title
uslup	üslup	style
vaʻd	vaat	promise  noun 
vakʻâ	vaka	event
vakûr	vakur	dignified
vasf	vasıf	feature  quality
vasıta	vasıta	vehicle
vâsi	vâsi	vast
vatan	vatan	homeland
vazîfe	vazife	task  mission
ve	ve	and
vehm	vehim	apprehension  fancy
vilâyet	vilayet	province
tefsîr	tefsir	interpretation  analysis  comment
dzabt	zabıt	minute of proceeding  trial
zamîr	zamir	pronoun
zaviye	zaviye	angle
agenda	ajanda 	agenda
accélération	akselerasyon	acceleration
accessoire	aksesuar 	accessory  decorative 
actif	aktif 	active
alternatif	alternatif 	alternative
analyse	analiz 	analysis
assimilation	asimilasyon	assimilation
anabolisme	anabolizma	anabolism
astronomie	astronomi 	astronomy
avantage	avantaj 	advantage
donnée	done	data
détail	detay 	detail
direct	direkt 	directly
dictée	dikte 	dictation
doctrine	doktrin	doctrine
document	doküman 	document
domestique	domestik 	domestic
dominant	dominant	dominant
exercice	egzersiz 	exercise
endémique	endemik 	endemic
énergie	enerji 	energy
inflammation	enflamasyon 	inflammation
informatique	enformatik	information technology
intéressant	enteresan 	interesting
érythrocyte	eritrosit	red blood cell
expert	eksper 	expert
fax	faks 	fax
facteur	faktör 	factor
phénomène	fenomen 	phenomenon
philologie	filoloji 	philology
filtre	filtre 	filter
physiologie	fizyoloji 	physiology
fonction	fonksiyon 	function
photocopie	fotokopi 	photocopy
garantie	garanti 	insurance  assurance
global	global 	global
grammaire	gramer	grammar
groupe	grup 	group
hallucination	halüsinasyon 	hallucination
histologie	histoloji	histology
homogène	homojen 	homogenous
illusion	illüzyon 	illusion
statistiques	istatistik 	statistics
isolation	izolasyon 	isolation
qualité	kalite 	quality
campus	kampüs 	campus
capacité	kapasite 	capacity
caractère	karakter 	character  personality
catégorie	kategori 	category
complexe	kompleks 	complex
communication	komünikasyon	communication
concentration	konsantrasyon 	concentration
consolidation	konsolidasyon 	consolidation  economics 
contrôle	kontrol 	control
corrélation	korelasyon	correlation
crampe	kramp 	 muscle  cramp
critères	kriter 	criteria
chronique	kronik 	chronic ally 
coiffeur	kuaför 	beauty/hair salon  barber
lymphe	lenf 	lymph
liste	liste 	list
leucocyte	lokosit	white blood cell
média	medya 	media
mécanisme	mekanizma 	mechanism
méridien	meridyen 	longitude
message		mesaj  posta 	message
métamorphose	metamorfoz 	metamorphosis
méthode	metot 	method
monotone	monoton 	monotonous
mobilier	mobilya 	furniture
morale	moral 	moral
mutation	mutasyon 	mutation
normal	normal 	normal
objectif	objektif 	objective
organisation	organizasyon 	organization
original	orijinal 	original
autorité	otorite 	authority
ovaire	over	ovary
paradoxe	paradoks 	paradox
parallèle	paralel 	latitude
parasite	parazit 	parasite
passif	pasif 	passive
performance	performans 	performance
plage	plaj 	beach
plateau	plato 	plateau
populaire  favori	popüler  favori 	popular  favorite
principe	prensip 	principal
présentation	prezentasyon	presentation
primaire	primer	primary
problème	problem 	problem
producteur	prodüktör	producer
programme	program 	program
projet	proje 	project
procédure	prosedür 	procedure
procès	proses	process
provocation	provokasyon	provocation
radioactif	radyoaktif 	radioactive
rendement	randıman 	efficiency
rapport	rapor 	report
régisseur	rejisör	director
récessif	resesif	recessive
restaurant	restoran 	restaurant
résistance	rezistans	resistance
secondaire	sekunder  sekonder	secondary
secrétaire	sekreter 	secretary
symbole	sembol 	symbol
symptôme	semptom 	symptom
syndrome	sendrom 	syndrome
synthèse	sentez 	synthesis
système	sistem 	system
simulation	simülasyon 	simulation
solution	solüsyon	solution
spécifique	spesifik	specific
spécial	spesiyal	special
standard	standart 	standard
statique	statik 	static
statut	statü 	status
subjectif	subjektif 	subjective
théorie	teori 	theory
trottoir	tretuvar	pavement / sidewalk
tumeur	tümör 	tumor
version	versiyon 	version
virage	viraj 	turn  as in traffic 
ultrason	ultrason 	ultrasound

Akroinon	Afyonkarahisar
Alexandretta	İskenderun
Amaseia	Amasya
Asklepios	İskilip
Astacus	İzmit
Baris	Isparta
Bythinion	Bolu
Clazomenae	Kilizman
Didyma	Didim
Ephesus	Efes
Gangra	Çankırı
Heraclea	Ereğli
Kallipolis	Gelibolu
Lampsacus	Lapseki
Magnesia	Manisa
Mylasa	Milas
Nicaea	Iznik
Ünü	Ünye
Pergamon	Bergama
Phocaea	Foça
Prousa	Bursa
Semasus	Amasra
Sinope	Sinop
Trebizond	Trabzon
Tripolis	Tirebolu
Truwa	Truva
Germanicia	Kahramanmaraş
Adrianople	Edirne
Archelaïs	Aksaray
Antioch	Antakya
Manzikert	Malazgirt
Attalea	Antalya
Miletus	Milet
Sebastia	Sivas
Melitene	Malatya
Iconium	Konya
Ancyra	Ankara
Smyrna	İzmir
Caesarea	Kayseri
Néa Phōkaia	Yenifoça
Kalamaki	Kalkan
Metskert	Mazgirt
Sevaverag	Siverek
Manavazkert	Malazgirt
Akn	Eğin
Çermuk	Çermik
Govdun	Goydun
Karpet	Harput 
Pertak	Pertek
Kayl Ket	Kelkit
Khachkar	Kaçkar
Everek	Develi
Ani	Anı
Aghtamar	Akdamar
Merdō	Mardin
Xisna dKēpha	Hasankeyf
Hēnī	Hani
